111111111111111111
100000000000000001
102000000000000001
100000000000000001
100000000000000001
100000000000000001
10000000W000000001
100000000000000001
100000000000000001
100000000000002001
100000000000000001
100000000000000001
111111111111111111

111111111111111111
100000000000000001
102001      100001
100000000000000001
100000000000000001
100000111111100001
10000000W000000001
100000111111100001
100000000000000001
100001      102001
100000000000000001
100000000000000001
111111111111111111


111111      111111
100001      100001
102001      100001
100001      100001
100001      100001
100000111111100001
10000000W000000001
100000111111100001
100001      100001
100001      102001
100001      100001
100001      100001
111111      111111


      1
     101
    10001   
   1000001    1
  100000001  101
 10000N0000110001
100000000000000001
111111111111111111


1111  1111
111    111
10      01
10  11  01
10  11  01
100200N001
10  11  01
10  11  01
10      01
111    111
1111  1111

