R 1920 1080

NO ./textures/BRICK4.xpm
SO ./textures/BSTONE1.xpm
WE ./textures/BRICK7.xpm
EA ./textures/BRICKLIT.xpm

S ./textures/barrel.xpm

F 0,0,0
C 255,255,255

111111111111111111
100000000000000001
102000000000000001
100000000000000001
100000000000002001
100000000000000001
10000000W000000001
100000000000000001
102000000000000001
100000000000002001
100000000000000001
100000000000000001
111111111111111111
