R 1920 1080

NO ./textures/BRICK4.xpm
SO ./textures/BSTONE1.xpm
WE ./textures/BRICK7.xpm
EA ./textures/BRICKLIT.xpm

S ./textures/barrel.xpm

F 0,0,0
C 255,255,255


      1
     101
    10001   
   1002001    1
  100000001  101
 10000N0000110001
100000000000000001
1111111111111111111
