R 1920 1080

NO ./textures/BRICK4.xpm
SO ./textures/BSTONE1.xpm
WE ./textures/BRICK7.xpm
EA ./textures/BRICKLIT.xpm

S ./textures/barrel.xpm

F 0,0,0
C 255,255,255

1111111111111111111111111111111
1000000000002000000000010020001
1000000000000000000000010000001
1000000000000000000000010000001
1000200000000000000000010000001
1000000000000000000000010000001
1000000000000000000000000000001
1000000000000001111111111111111
1000000000000001
1000200000000001
1000000000000001
1000000000000001                      111111111111111111111111
10000000000000011111111111111111111111100000000000000000000001
10000000000000000000000000000000000000000200000000000000000001
10000020000000000000000111111111111111100000000000000000020001
111111111111111111111111              100000000000000000000001
                                      100000000000000000000001
                                      100002000000000000000001
                                      100000000000000000000001
                                      100000000111111000000001
                                      1000000001    1000000001
                                      1000000001    1000000001
                                      1000000001    1000000001
                                      1111111111    100000000111111111111
                                                    111111000000000000E01
                                                         1101111111111111
                                                         1111

